11111111111111111111111111111111111111111111111111111
111111P1000000000000000000000000000000000000000000001
11111001000000000000000000000000000000000000000000001
11110010000000000000000000000000000000000000000000001
11100100000000000000000000000000000000000000000000001
11001000000000000000000000000000000000000000000000001
10010000000000000000000000000000000000000000000000001
10100000000000000000000000000000000000000000000000101
10000000000000000000000000000000000000000000000001001
10100000000000000000000000000000000000000000000010001
11111111111111111111111111111111111111111111111111111